111111111111111
10001C0000000C1
100010010110001
1P0010010110001
11C000010C110E1
111111111111111