1111111111
10000C0001
1P00000001
100000E001
10C0000001
1111111111