1111111111
10000C0001
1P00000001
1000000001
10C00000E1
1111111111