111111111111111
10001C0000000C1
100010010110001
1P00100101100E1
11C000010C11111
111111111111111