11111111111111111111
1P0000011000010000C1
100J000110J101000011
10C1000110010000J111
1001000000C1000C00E1
11111111111111111111