1111111111111111111111
111000011C000000000C11
1000000110000111000011
100C0000J00000000000C1
1000000000000000J10001
10J00000000C100001J001
1111100000011100C100E1
1C00100011111000011111
1000000J0000000000P111
1111111111111111111111