111111111111111111111111111111111111111
1110001C00000000C11111C0011C000000000C1
10000J110000000001111100011100000000011
1000001100000000000J110000110000000J111
1C0001100000000000001100000000110000111
100000000000000000001100J100001100000C1
111C00000C000000C0000000010000010000011
110000001100000C11111111110000000000011
10000J11110000C11100000C0000000000J1111
1000000110000C11100000011111100000E0001
11P000C1100C1111J00000000000000000000C1
111111111111111111111111111111111111111